Name Level_1
	123456789
Map
### #####
x5
x10
### O####
x3
###   ###
x3
### #O###
x20
#####"###
#####"###
### # ###
x15
###   ###
x10
###"# ###
###"# ###
### # ###
x20
###O O###
x5
##### ###
x10
###O  ###
x20
End 